20 20
0 0
4 4 4 4 4 4 4 4 4 4 4 4 4 4 4 4 4 4 4 4
4 2 2 2 2 2 2 2 2 2 2 2 2 2 2 2 2 2 2 4
4 2 6 5 5 5 5 5 5 5 5 5 5 5 5 5 5 7 2 4
4 2 1 0 0 0 0 0 0 0 0 0 0 0 0 0 0 9 2 4
4 2 1 0 0 0 0 0 0 0 0 0 0 0 0 0 0 9 2 4
4 2 1 0 0 0 0 0 0 0 0 0 0 0 0 0 0 9 2 4
4 2 1 0 0 0 0 0 0 0 0 0 0 0 0 0 0 9 2 4
4 2 1 0 0 0 0 0 0 0 0 0 0 0 0 0 0 9 2 4
4 2 1 0 0 0 0 0 0 0 0 0 0 0 0 0 0 9 2 4
4 2 1 0 0 0 0 0 0 0 0 0 0 0 0 0 0 9 2 4
4 2 1 0 0 0 0 0 0 0 0 0 0 0 0 0 0 9 2 4
4 2 1 0 0 0 0 0 0 0 0 0 0 0 0 0 0 9 2 4
4 2 1 0 0 0 0 0 0 0 0 0 0 0 0 0 0 9 2 4
4 2 1 0 0 0 0 0 0 0 0 0 0 0 0 0 0 9 2 4
4 2 1 0 0 0 0 0 0 0 0 0 0 0 0 0 0 9 2 4
4 2 1 0 0 0 0 0 0 0 0 0 0 0 0 0 0 9 2 4
4 2 1 0 0 0 0 0 0 0 0 0 0 0 0 0 0 9 2 4
4 2 10 8 8 8 8 8 8 8 8 8 8 8 8 8 8 3 2 4
4 2 2 2 2 2 2 2 2 2 2 2 2 2 2 2 2 2 2 4
4 4 4 4 4 4 4 4 4 4 4 4 4 4 4 4 4 4 4 4